{
  "tiles": [
    [16, 16, 16, 16, 25, 26, 27, 28, 16, 16],
    [16, 16, 16, 21, 29, 30, 31, 32, 22, 16],
    [16, 16, 16, 17, 33, 34, 35, 36, 15, 16],
    [16, 16, 16, 23, 14, 1, 9, 1, 15, 16],
    [16, 21, 19, 22, 17, 3, 9, 1, 15, 16],
    [16, 17, 11, 15, 17, 1, 9, 1, 15, 16],
    [16, 17, 9, 18, 20, 1, 9, 3, 15, 16],
    [16, 17, 37, 4, 4, 4, 5, 1, 15, 16],
    [16, 23, 13, 13, 13, 13, 13, 13, 24, 16],
    [16, 16, 16, 16, 16, 16, 16, 16, 16, 16]
  ]
}
