{
  "tiles": [
    [3, 3, 3, 3, 3, 3, 3, 3, 3, 3],
    [3, 1, 1, 2, 1, 2, 1, 2, 1, 3],
    [4, 4, 4, 4, 4, 4, 4, 4, 1, 3],
    [3, 1, 4, 1, 1, 1, 1, 1, 1, 3],
    [3, 1, 4, 1, 3, 3, 3, 3, 3, 3],
    [3, 1, 4, 1, 3, 3, 3, 3, 3, 3],
    [3, 1, 4, 1, 3, 2, 6, 7, 8, 3],
    [3, 1, 4, 4, 4, 4, 4, 5, 1, 3],
    [3, 1, 1, 1, 1, 1, 1, 3, 1, 3],
    [3, 3, 3, 3, 3, 3, 3, 3, 3, 3]
  ]
}
